NO ./assets/textures/north.png
SO ./assets/textures/south.png
WE ./assets/textures/west.png
EA ./assets/textures/east.png

F 102,255,102
C 204,255,255

        1111111111111111111111111
        1000000000110000000000001
        1011000001110000000000001
        1001000000000000000000001
111111111011000001110000000000001
100000000011000001110111111111111
1111D111111111011100000010001
11110111  11111011101010010001
11000001110101011100000010001
10000000000000001100000010001
10000000000000001101010000001
11000001110101011111011110E0111
11110111 1110101 101111010001
11111111 1111111 111111111111
